30005039,6
30005040,6
30005078,5
30025042,4
30025042,4
30025042,4
30005035,5
30005044,3
30005038,5
30045042,6
30045042,6
30005042,4
30045042,6
30005037,5
30005055,13
30005084,9
30005060,16
30005045,2
30005045,2
30005037,5
30005037,5
30005037,5
30005060,16
30005060,16
30045042,6
30005038,5
30005058,15
30005044,3
30005056,13
30005037,5
30005070,1
